NO ./path_to_north_texture
SO ./path_to_south_texture
WE ./path_to_west_texture
EA ./path_to_east_texture

F 220,100,0
C 225,30,0

1111111111111111
1001010000000011
1010010000000011
1000N10000000011
1000000000000011
1010000000000011
1000000000000011
1111111111111111
