NO ./path_to_north_texture
SO ./path_to_south_texture
WE ./path_to_west_texture
EA ./path_to_east_texture

F 220,100,0
C 0,0,0

11111111
10010001
10100101
10N00101
10000001
10100001
10000001
11111111
