NO ./wall_N.xpm
SO ./wall_S.xpm
WE ./wall_W.xpm
EA ./wall_E.xpm

F 220,100,0
C 0,0,0

11111111
10010001
10100101
10N00101
11111111
